####################################################################################################################################################################################
#                                            #                                                                                                                                     #
#                                            #                     ####################################################                                                            #
#                                            #                     #                                                  #                                                            #
#                                            #                     #                                                  #                                                            #
#                              #             #                     #                                                  #                                                            #
#                              #             #                     #                        #                         #                                                            #
#                              #             #                     #                        #                         #                                                            #
#                              #             #                     #                        #                         #                                                            #
#                              #             #                     #                        #                         #                                                            #
#                              #             #                     #                        #                         #                                                            #
#                              #             #                     #                        #                         #                                                            #
#                              #             #                     #                        #                         #                                                            #
#                              #             #                     #                        #                         #                                                            #
#                              #             #                     #                        #                         #                                                            #
#                              #             #                     #                        #                         #                                                            #
#                              #             #                     #                        #                         #                                                            #
#                              #             #                     #                        #                         #                                                            #
#                              #             #                     #                        #                         #                                                            #
#                              #             #                     #                        #                         #                                                            #
#                              #             #                     #                        #                         #                                                            #
#                              #             #                     #                        #                         #                                                            #
#                              #             #                     #                        #                         #                                                            #
#                              #             #                     #                        #                         #                                                            #
#                              #             #                     #                        #                         #                                                            #
#                              #             #                     #                        #                         #                                                            #
#                              #             #                     #                        #                         #                                                            #
#                              #             #                     #                        #                         #                                                            #
#                              #             #                     #                        #                         #                                                            #
#                              #             #                     #                        #                         #                                                            #
#                              #             #                                              #                         #                                                            #
#                              #             #                                              #                         #                                                            #
#                              #             #                                              #                         #                                                            #
#                              #             #                                              #                         #                                                            #
#                              #                                                            #                         #                                                            #
#           ####################                                                            #                         #                                                            #
#                                                                                           #                         #                                                            #
#                                                                                           #                         #                                                            #
#                                                                                           #                                                                                      #
####################################################################################################################################################################################